general mitchell international airport	general_mitchell_airport
general mitchell international	general_mitchell_airport
general mitchell airport	general_mitchell_airport
general mitchell	general_mitchell_airport
baltimore washington airport	baltimore_washington_airport
baltimore washington	baltimore_washington_airport
baltimore airport	baltimore_washington_airport
toronto international airport	toronto_international
toronto international	toronto_international
toronto airport	toronto_international
rental cars	rental car
car rentals	rental car
orlando international airport	orlando_international
orlando international	orlando_international
dallas forth worth	forth_worth
forth worth	forth_worth
la guardia airport	la_guardia_airport
la guardia	la_guardia_airport
pittsburgh airport	pittsburgh_airport
 fly	 flight 
new york city	new york
montreal canada	montreal
montreal quebec	montreal
tacoma washington	tacoma
san diego california	san diego
las vegas	vegas
vegas	vegas
oakland california	oakland
houston texas	houston
cleveland ohio	cleveland
newark new jersey	newark
washington dc	washington
pheonix arizona	pheonix
ontario canada	ontario
columbus ohio	columbus
alaska airlines	alaska_a
delta airlines	delta_a
delta airline	delta_a
delta's	delta_a
delta	delta_a
american airlines	american_a
american airline	american_a
american	american_a
eastern airlines	eastern_a
eastern airline	eastern_a
eastern	eastern_a
united airlines	united_a
united airline	united_a
united	united_a
trans world airlines	trans_a
trans world airline	trans_a
trans world	trans_a
 twa 	trans_a
midwest express airlines	midwest_a
midwest express airline	midwest_a
midwest express	midwest_a
northwest airlines	northwest_a
northwest airline	northwest_a
northwest	northwest_a
southwest airlines	southwest_a
southwest airline	southwest_a
southwest	southwest_a
continental airlines	continental_a
first class ticket	first_class
first class service	first_class
first class fare	first_class
first class	first_class
business class ticket	business_class
business class service	business_class
business class fare	business_class
business class	business_class
economy class ticket	economy_class
economy class service	economy_class
economy class fare	economy_class
economy class	economy_class
economy fare	economy_class
thirty second	32
thirty first	31
thirty	30
thirtieth	30
twenty ninth	29
twenty nine	29
twenty eighth	28
twenty eight	28
twenty seventh	27
twenty seven	27
twenty sixth	26
twenty fifth	25
twenty fourth	24
twenty four	24
twenty third	23
twenty three	23
twenty second	22
twenty two	22
twenty first	21
twenty one	21
twenty	20
nineteenth	19
eighteenth	18
eighteenth	18
seventeenth	17
seventeen	17
sixteenth	16
sixteen	16
fifteenth	15
fifteen	15
fourteenth	14
fourteen	14
thirteenth	13
thirteen	13
twelfth	12
twelve	12
eleventh	11
eleven	11
tenth	10
ten	10
ninth	9
nine	9
eighth	8
eight	8
seventh	7
seven	7
sixth	6
six	6
fifth	5
five	5
fourth	4
third	3
second	2
stopovers	layover
stopover	layover
 la california	los angeles
 la 	los angeles
 noon	 12pm
WHERE(	WHERE (
SELECT(	SELECT (
AND(	AND (
MIN(	MIN (
MAX(	MAX (
count(	count (
OR(	OR (
0100	100
0200	200
0300	300
0400	400
0500	500
0600	600
0700	700
0800	800
0900	900